"filename", "language", "C#", "SQL", "", "comment", "blank", "total"
"f:\Projets\L3\S6\Proies Prédateurs\trunk\Assets\Scripts\Camera\BasicCamera.cs", "C#", 50, 0, 0, 43, 17, 110
"f:\Projets\L3\S6\Proies Prédateurs\trunk\Assets\Scripts\Camera\CameraUtils\EditorGrid.cs", "C#", 100, 0, 0, 90, 23, 213
"f:\Projets\L3\S6\Proies Prédateurs\trunk\Assets\Scripts\Camera\CameraUtils\SmoothCameraRotation.cs", "C#", 32, 0, 0, 47, 11, 90
"f:\Projets\L3\S6\Proies Prédateurs\trunk\Assets\Scripts\Camera\CameraUtils\SmoothCameraTranslation.cs", "C#", 32, 0, 0, 47, 12, 91
"f:\Projets\L3\S6\Proies Prédateurs\trunk\Assets\Scripts\Camera\WeatherCamera.cs", "C#", 82, 0, 0, 97, 34, 213
"f:\Projets\L3\S6\Proies Prédateurs\trunk\Assets\Scripts\Constants\SceneNames.cs", "C#", 6, 0, 0, 6, 2, 14
"f:\Projets\L3\S6\Proies Prédateurs\trunk\Assets\Scripts\Constants\UINames.cs", "C#", 14, 0, 0, 8, 3, 25
"f:\Projets\L3\S6\Proies Prédateurs\trunk\Assets\Scripts\Constants\WeatherNames.cs", "C#", 15, 0, 0, 7, 3, 25
"f:\Projets\L3\S6\Proies Prédateurs\trunk\Assets\Scripts\DB\DBHelper.cs", "C#", 52, 0, 0, 115, 17, 184
"f:\Projets\L3\S6\Proies Prédateurs\trunk\Assets\Scripts\DB\DBInit.cs", "C#", 21, 0, 0, 44, 9, 74
"f:\Projets\L3\S6\Proies Prédateurs\trunk\Assets\Scripts\DB\tables_creation.sql", "SQL", 0, 66, 0, 3, 0, 69
"f:\Projets\L3\S6\Proies Prédateurs\trunk\Assets\Scripts\GUI\AutotropheEvents.cs", "C#", 29, 0, 0, 32, 8, 69
"f:\Projets\L3\S6\Proies Prédateurs\trunk\Assets\Scripts\GUI\DropShadow.cs", "C#", 97, 0, 0, 13, 22, 132
"f:\Projets\L3\S6\Proies Prédateurs\trunk\Assets\Scripts\GUI\MenuTransition.cs", "C#", 23, 0, 0, 34, 9, 66
"f:\Projets\L3\S6\Proies Prédateurs\trunk\Assets\Scripts\GUI\PredateurEvents.cs", "C#", 29, 0, 0, 32, 8, 69
"f:\Projets\L3\S6\Proies Prédateurs\trunk\Assets\Scripts\GUI\ProieEvents.cs", "C#", 29, 0, 0, 32, 8, 69
"f:\Projets\L3\S6\Proies Prédateurs\trunk\Assets\Scripts\GUI\WeatherEvents.cs", "C#", 51, 0, 0, 51, 11, 113
"f:\Projets\L3\S6\Proies Prédateurs\trunk\Assets\Scripts\Simulation\DayNightCycle\LightningManager.cs", "C#", 41, 0, 0, 29, 9, 79
"f:\Projets\L3\S6\Proies Prédateurs\trunk\Assets\Scripts\Simulation\DayNightCycle\LightningPresets.asset", "", 0, 0, 101, 0, 1, 102
"f:\Projets\L3\S6\Proies Prédateurs\trunk\Assets\Scripts\Simulation\DayNightCycle\LightningPresets.cs", "C#", 7, 0, 0, 9, 2, 18
"f:\Projets\L3\S6\Proies Prédateurs\trunk\Assets\Scripts\Simulation\Weather\Weather.cs", "C#", 5, 0, 0, 7, 3, 15
"f:\Projets\L3\S6\Proies Prédateurs\trunk\Assets\Scripts\Simulation\Weather\WeatherZoning.cs", "C#", 12, 0, 0, 21, 8, 41
"Total", "-", 727, 66, 101, 767, 220, 1881